NO ./texture/xpm/alien_wall.xpm
SO ./texture/xpm/alien_puss.xpm
WE ./texture/xpm/alien.xpm
EA ./texture/xpm/wall_futur_2.xpm

F 0,0,0
C 0,255,0

1111111111
1000000001
1000000001
1000000001
1000000001
1000000001
1000000001
1000000001
1000000001
1111DD1111
1000000001
1000000001
1000000001
1000000001
1000000001
1000000001
1000000001
1000N00001
1111111111
