NO ./texture/xpm/wall_north.xpm
SO ./texture/xpm/wall_south.xpm
WE ./texture/xpm/wall_west.xpm
EA ./texture/xpm/wall_east.xpm

F 70,70,70
C 220,100,0

1111111111111111111111111111111111111111111111111111
1000000000000111111111111111111111100000000000000001
1000000000000011111111111111111111110011110000000001
100000110000001111111111111111111111001111000011D101
10000000000000D000000100000001111111D111110000100101
100000000000001000000000100000000000E011110000100101
1000001100000011111111111111111111111111111111111111
1000000000000010000000000000000000000000000000000001
100000000000000D000000000011111111000000000011111111
1111111111111111000000000000000000000000000111111111
1111111111111111111111111111111111111111111111111111