NO ./texture/xpm/wall/wall_north.xpm
SO ./texture/xpm/wall/wall_south.xpm
WE ./texture/xpm/wall/wall_west.xpm
EA ./texture/xpm/wall/wall_east.xpm

F 70,70,70
C 220,100,0

111111111111111111111111111111111111111111111111111111111
100000000000011111111111111111111110000000000000000111111
100000000000001111111111111111111111001111000000000111111
100000110000001111111111111111111111001111000011D10111111
100000X0000000D000000100000001111111D11111000010X10111111
100X00000000001000000000100000000000E01111000010010111111
100000110000001111111111111111111111111111111111111111111
100000000000001000000000000000000000000000000000000000001
100000000000000D00000000001111111100000000001111111100001
111111111111111100000000000000000000000000011111111100001
111111111111111111111111111111111111111111111111111100001
111111111111111111111111111111111111111111111111111111111