NO ./texture/xpm/wall/wall_north.xpm
SO ./texture/xpm/wall/wall_south.xpm
WE ./texture/xpm/wall/wall_west.xpm
EA ./texture/xpm/wall/wall_east.xpm

F 255,255,255
C 0,0,255



        111111111111111111111
        100000000011000000001
        101100000111000000001
        100100000000000000001
11111111101100000111000000001
1000000000110N000111011111111
111101111111110111000000000011
111101111111110111010100100001
110000001101010111000000100011
10000000000000001100000010001
10000000000000001101010010001
11000001110101011111011110001
11110111 1110101 101111010001
11111111 1111111 111111111111