NO
SO
WE
EA
F
C

111111111111111
100000S00000001
100000000000001
100000110000001111111111111111
100000000000000000001000000001
100000000000000000000000001111
10000011000000111111111111
100000000000001
100000000000001
111111111111111