NO ./texture/xpm/wall_futur.xpm
SO ./texture/xpm/wall_futur.xpm
WE ./texture/xpm/wall_futur.xpm
EA ./texture/xpm/wall_futur.xpm

F 220,100,0
C 225,30,0

111111111111111111111111111111111111111111
111111111111111111111111111111111111000001
100000S00000001111111111111111111111000001
100000000000001111111111111111111111001111
100000110000001111111111111111111111001111
10000000000000D000000100000001111111DD1111
10000000000000D000000000100000000000001111
100000110000001111111111111111111111111111
1000000000000011
1000000000000011
1111111111111111