NO ./texture/xpm/wall_north.xpm
SO ./texture/xpm/wall_south.xpm
WE ./texture/xpm/wall_west.xpm
EA ./texture/xpm/wall_east.xpm

F 70,70,70
C 220,100,0

 11111111111111111111111111111111111111111
10000000000001111111111111111111111000001
100000000000001111111111111111111111001111
100000110000001111111111111111111111001111
10000000000000D000000100000001111111DD1111
10000000000000D000000000100000000000001111
100000110000001111111111111111111111111111
100000000N0000011
10000000000000011 
1111111111111111
