NO ./texture/xpm/wall_futur.xpm
SO ./texture/xpm/wall_futur.xpm
WE ./texture/xpm/wall_futur.xpm
EA ./texture/xpm/wall_futur.xpm

F 220,100,0
C 225,30,0

111111
100001
10N001
10000
111111